Term	CS-MODL Count	CS-MODL Files	Enslaved-MODL Count	Enslaved-MODL Files	Total Count
hasPart	15	['Air', 'Back', 'Body', 'Eye', 'Face', 'Hand', 'Head', 'Home', 'Kind', 'Morning', 'Part', 'Program', 'System', 'Thing', 'World']	6	['activity', 'body', 'day', 'head', 'introduction', 'part']	21
isPartOf	24	['Body', 'City', 'Eye', 'Group', 'Hand', 'History', 'Hour', 'Law', 'Moment', 'Morning', 'Night', 'Number', 'Office', 'Part', 'Place', 'Program', 'Room', 'State', 'Study', 'System', 'Thing', 'Time', 'Way', 'World']	7	['body', 'island', 'period', 'room', 'sea', 'thousand', 'trader']	31
assignedTo	2	['Case', 'Issue']	2	['regiment', 'task']	4
description	17	['Case', 'Fact', 'Group', 'Idea', 'Issue', 'Job', 'Kind', 'Moment', 'Others', 'Part', 'Problem', 'Program', 'Research', 'Service', 'Thing', 'Time', 'Work']	8	['detail', 'exhibit', 'favor', 'fund', 'project', 'service', 'task', 'website']	25
dueDate	2	['Issue', 'Research']	3	['debt', 'effort', 'task']	5
hasDateCreated	2	['Idea', 'Issue']	1	['idea']	3
hasDeadline	3	['Issue', 'Team', 'Work']	3	['opportunity', 'project', 'task']	6
hasDescription	13	['Case', 'Fact', 'History', 'Idea', 'Issue', 'Job', 'Level', 'Moment', 'Part', 'Problem', 'Program', 'Story', 'Thing']	7	['attempt', 'course', 'issue', 'photo', 'principle', 'shop', 'task']	20
hasID	6	['Case', 'Issue', 'Member', 'Student', 'Study', 'Teacher']	3	['course', 'soldier', 'worker']	9
hasId	4	['Fact', 'Issue', 'Problem', 'Program']	1	['request']	5
hasIssue	1	['Issue']	1	['issue']	2
hasName	60	['Area', 'Art', 'Book', 'Business', 'Child', 'City', 'Community', 'Company', 'Country', 'Day', 'Family', 'Friend', 'Game', 'Girl', 'Government', 'Group', 'Guy', 'Health', 'History', 'Home', 'House', 'Idea', 'Issue', 'Kid', 'Kind', 'Law', 'Life', 'Man', 'Member', 'Moment', 'Month', 'Mother', 'Name', 'Office', 'Others', 'Parent', 'Party', 'People', 'Person', 'Place', 'President', 'Program', 'Research', 'Room', 'School', 'Service', 'State', 'Story', 'Student', 'Study', 'System', 'Teacher', 'Team', 'Thing', 'War', 'Way', 'Week', 'Woman', 'Work', 'World']	66	['activity', 'actor', 'artist', 'auction', 'author', 'battle', 'cemetery', 'church', 'citation', 'company', 'country', 'county', 'course', 'domain', 'donation', 'enslaver', 'film', 'girl', 'guest', 'hero', 'household', 'idea', 'individual', 'institution', 'island', 'lawyer', 'level', 'life', 'man', 'material', 'merchant', 'missionary', 'nation', 'neighbor', 'obituary', 'officer', 'organization', 'overseer', 'page', 'painter', 'party', 'petition', 'photo', 'pilgrimage', 'plan', 'poem', 'politician', 'principle', 'project', 'reader', 'resident', 'result', 'road', 'seamstress', 'ship', 'shop', 'skill', 'speaker', 'story', 'study', 'subject', 'tavern', 'theme', 'town', 'website', 'woman']	126
hasPriority	1	['Issue']	1	['issue']	2
hasSeverity	3	['Health', 'Issue', 'Problem']	5	['assault', 'damage', 'fire', 'injury', 'pain']	8
hasStatus	3	['Case', 'Issue', 'Law']	2	['request', 'status']	5
hasTitle	15	['Art', 'Book', 'Case', 'Game', 'Idea', 'Information', 'Issue', 'Job', 'Law', 'Problem', 'Question', 'Research', 'Story', 'Study', 'Work']	22	['association', 'author', 'book', 'citation', 'course', 'diary', 'document', 'film', 'information', 'manuscript', 'newspaper', 'page', 'paper', 'petition', 'photo', 'poem', 'prince', 'report', 'story', 'study', 'tale', 'task']	37
isAssignedTo	1	['Issue']	2	['officer', 'task']	3
isOpen	3	['Case', 'Door', 'Issue']	1	['issue']	4
isRelatedTo	4	['Case', 'Idea', 'Issue', 'Lot']	2	['principle', 'skill']	6
issueDescription	1	['Issue']	1	['issue']	2
issueID	1	['Issue']	1	['issue']	2
issueStatus	1	['Issue']	1	['issue']	2
personName	4	['Case', 'Community', 'Company', 'Issue']	1	['history']	5
status	2	['Case', 'Issue']	1	['guest']	3
title	13	['Art', 'Book', 'Case', 'Game', 'Information', 'Issue', 'Job', 'Law', 'Research', 'Story', 'Study', 'Time', 'Work']	16	['article', 'bibliography', 'book', 'diary', 'example', 'exhibit', 'film', 'gospel', 'literature', 'manuscript', 'memoir', 'novel', 'publication', 'publisher', 'song', 'website']	29
affiliation	1	['Research']	1	['researcher']	2
belongsTo	17	['Art', 'Case', 'Community', 'Eye', 'Family', 'Hand', 'History', 'Lot', 'Member', 'Part', 'President', 'Research', 'Result', 'Room', 'School', 'State', 'Study']	6	['activist', 'background', 'branch', 'piece', 'society', 'university']	23
endDate	10	['Art', 'Case', 'End', 'Job', 'Moment', 'President', 'Research', 'Team', 'War', 'Work']	6	['ability', 'contract', 'exhibit', 'period', 'project', 'work']	16
hasAuthor	7	['Art', 'Book', 'Idea', 'Information', 'Program', 'Research', 'Story']	22	['audiobook', 'autobiography', 'bibliography', 'biography', 'book', 'citation', 'comment', 'diary', 'document', 'information', 'manuscript', 'newspaper', 'page', 'paper', 'poem', 'preface', 'record', 'report', 'research', 'story', 'tale', 'text']	29
hasEndDate	8	['Case', 'End', 'History', 'Job', 'Program', 'Research', 'War', 'Work']	7	['association', 'controversy', 'expedition', 'meeting', 'party', 'plan', 'travel']	15
hasPublicationDate	3	['Book', 'Information', 'Research']	4	['author', 'biography', 'book', 'paper']	7
hasResearcher	2	['Research', 'Study']	1	['study']	3
hasStartDate	7	['Case', 'History', 'Job', 'Program', 'Research', 'War', 'Work']	7	['association', 'controversy', 'expedition', 'meeting', 'party', 'plan', 'travel']	14
hasSubject	7	['Case', 'Education', 'Fact', 'Information', 'Research', 'Study', 'Teacher']	12	['biography', 'class', 'controversy', 'desire', 'mail', 'photo', 'school', 'statement', 'study', 'subject', 'thought', 'view']	19
hasTopic	2	['Research', 'Study']	2	['conversation', 'speaker']	4
isAbout	3	['Fact', 'Information', 'Research']	2	['activist', 'biographer']	5
isWrittenBy	1	['Research']	2	['biographer', 'diary']	3
name	50	['Art', 'Book', 'Business', 'Child', 'City', 'Community', 'Company', 'Country', 'Education', 'Family', 'Friend', 'Game', 'Girl', 'Government', 'Group', 'Guy', 'History', 'Information', 'Job', 'Kid', 'Kind', 'Law', 'Life', 'Man', 'Member', 'Mother', 'Office', 'Others', 'Part', 'Party', 'People', 'Person', 'Place', 'Problem', 'Program', 'Research', 'Room', 'School', 'Service', 'State', 'Story', 'Student', 'Study', 'System', 'Teacher', 'Team', 'Thing', 'Way', 'Work', 'World']	65	['ability', 'account', 'activism', 'activist', 'actor', 'ancestry', 'battle', 'bibliography', 'boy', 'captain', 'cemetery', 'census', 'character', 'chef', 'community', 'convention', 'disease', 'editor', 'exhibit', 'film', 'fugitive', 'fund', 'gift', 'governor', 'group', 'guest', 'hero', 'home', 'instance', 'laborer', 'lawyer', 'memorial', 'monument', 'nation', 'native', 'origin', 'passenger', 'person', 'place', 'plantation', 'prisoner', 'project', 'property', 'publisher', 'regiment', 'region', 'release', 'researcher', 'scholar', 'seamstress', 'servant', 'service', 'settlement', 'state', 'store', 'support', 'supporter', 'system', 'task', 'teacher', 'tour', 'trader', 'treatment', 'vessel', 'website']	115
performs	1	['Research']	2	['agent', 'favor']	3
publishedIn	2	['Book', 'Research']	2	['author', 'press']	4
publishes	1	['Research']	2	['obituary', 'publisher']	3
researchTopic	1	['Research']	1	['research']	2
specializesIn	1	['Research']	3	['bondage', 'editor', 'seamstress']	4
startDate	10	['Art', 'Case', 'End', 'Job', 'Moment', 'President', 'Research', 'Team', 'War', 'Work']	6	['ability', 'contract', 'exhibit', 'period', 'project', 'work']	16
studies	5	['Education', 'Research', 'School', 'Student', 'Study']	1	['university']	6
supports	1	['Research']	1	['supporter']	2
hasLength	6	['Line', 'Night', 'Side', 'Sofa', 'Way', 'Word']	3	['coast', 'road', 'word']	9
relatedTo	4	['Fact', 'Law', 'Others', 'Side']	2	['idea', 'skill']	6
age	18	['Child', 'Community', 'Education', 'Family', 'Friend', 'Girl', 'Kid', 'Man', 'Member', 'Mother', 'Others', 'Parent', 'Party', 'People', 'Person', 'School', 'Student', 'Teacher']	15	['boy', 'fugitive', 'governor', 'guest', 'hero', 'home', 'horse', 'instance', 'passenger', 'person', 'prisoner', 'researcher', 'servant', 'support', 'supporter']	33
attends	6	['Education', 'Kid', 'Others', 'School', 'Student', 'Study']	3	['party', 'society', 'student']	9
gender	8	['Child', 'Community', 'Family', 'Kid', 'Others', 'People', 'Person', 'Student']	4	['guest', 'instance', 'physician', 'researcher']	12
hasAge	26	['Child', 'Community', 'Company', 'Family', 'Friend', 'Girl', 'Government', 'Group', 'Guy', 'Health', 'Home', 'Idea', 'Kid', 'Life', 'Man', 'Member', 'Mother', 'Others', 'Parent', 'People', 'Person', 'Student', 'Teacher', 'Woman', 'Work', 'World']	13	['actor', 'girl', 'household', 'individual', 'man', 'obituary', 'party', 'passenger', 'people', 'reader', 'resident', 'speaker', 'woman']	39
hasColor	10	['Car', 'Chair', 'Couch', 'Door', 'Eye', 'Face', 'Loveseat', 'Others', 'Sofa', 'Thing']	11	['appearance', 'black', 'box', 'cotton', 'eye', 'figure', 'life', 'material', 'painting', 'planter', 'suit']	21
hasLocation	24	['Area', 'Back', 'Business', 'Change', 'Community', 'Company', 'Girl', 'Guy', 'History', 'Home', 'Job', 'Law', 'Lot', 'Moment', 'Office', 'Others', 'Party', 'Place', 'Service', 'Story', 'Student', 'Study', 'War', 'Work']	26	['arrest', 'battle', 'branch', 'cabin', 'church', 'company', 'emancipation', 'estate', 'event', 'guard', 'injury', 'kidnapping', 'meeting', 'memorial', 'merchant', 'party', 'photo', 'plaque', 'play', 'scene', 'situation', 'statue', 'tavern', 'tour', 'troop', 'violence']	50
hasManufacturer	6	['Car', 'Couch', 'Loveseat', 'Others', 'Part', 'Sofa']	1	['carriage']	7
hasNationality	5	['Man', 'Others', 'People', 'President', 'Woman']	3	['actor', 'individual', 'worker']	8
hasOccupation	8	['Guy', 'Man', 'Mother', 'Others', 'People', 'Person', 'Woman', 'Work']	1	['preacher']	9
hasShape	4	['Eye', 'Face', 'Others', 'Thing']	4	['appearance', 'box', 'eye', 'figure']	8
livesIn	7	['Girl', 'Guy', 'Home', 'Others', 'People', 'Person', 'World']	2	['person', 'relation']	9
location	16	['Art', 'Community', 'Company', 'Friend', 'History', 'Job', 'Lot', 'Office', 'Others', 'Party', 'Place', 'School', 'Service', 'Team', 'War', 'Work']	22	['arrest', 'audience', 'cabin', 'cemetery', 'ceremony', 'chef', 'circumstance', 'community', 'congregation', 'convention', 'damage', 'exhibit', 'funeral', 'memorial', 'monument', 'occasion', 'plantation', 'publisher', 'sea', 'speech', 'trader', 'wedding']	38
provides	16	['Air', 'Business', 'Education', 'Head', 'Health', 'Information', 'Man', 'Money', 'Others', 'Part', 'People', 'Reason', 'School', 'Service', 'System', 'Water']	1	['service']	17
endOfYear	1	['Year']	1	['year']	2
hasEvent	7	['Community', 'Day', 'History', 'Moment', 'Party', 'Reason', 'Year']	3	['decade', 'scene', 'spring']	10
hasYear	4	['Art', 'Car', 'Law', 'Year']	3	['carriage', 'citation', 'year']	7
year	3	['Art', 'Car', 'Year']	2	['census', 'publication']	5
birthDate	8	['Art', 'Book', 'Company', 'Family', 'History', 'Life', 'People', 'Person']	2	['cemetery', 'film']	10
deathDate	5	['Art', 'Book', 'Family', 'History', 'Life']	1	['cemetery']	6
hasBirth	1	['Life']	1	['birth']	2
hasChild	11	['Child', 'Family', 'Father', 'Guy', 'Life', 'Man', 'Mother', 'Parent', 'People', 'Person', 'Woman']	4	['ancestor', 'ancestry', 'descent', 'parent']	15
hasDeath	1	['Life']	1	['death']	2
hasEnd	7	['End', 'Life', 'Line', 'Moment', 'Night', 'Time', 'Way']	2	['end', 'spring']	9
hasParent	10	['Child', 'Family', 'Girl', 'Kid', 'Life', 'Man', 'Mother', 'Parent', 'People', 'Person']	5	['ancestor', 'descent', 'mother', 'parent', 'reproduction']	15
hasSibling	6	['Child', 'Family', 'Kid', 'Life', 'Man', 'Person']	3	['ancestry', 'descent', 'relation']	9
brand	3	['Couch', 'Loveseat', 'Sofa']	1	['marker']	4
color	8	['Car', 'Couch', 'Door', 'Eye', 'Face', 'Loveseat', 'Room', 'Sofa']	6	['clothe', 'dress', 'horse', 'marker', 'print', 'thing']	14
depth	3	['Couch', 'Loveseat', 'Water']	1	['sea']	4
hasMaterial	6	['Chair', 'Couch', 'Door', 'Loveseat', 'Money', 'Sofa']	8	['box', 'carriage', 'figure', 'heming', 'material', 'planter', 'statue', 'suit']	14
hasPrice	9	['Car', 'Chair', 'Company', 'Couch', 'Game', 'House', 'Lot', 'Service', 'Sofa']	7	['price', 'purchase', 'shop', 'total', 'trade', 'trading', 'travel']	16
hasSize	11	['Area', 'Couch', 'Eye', 'Face', 'Home', 'Lot', 'Loveseat', 'Part', 'Room', 'Sofa', 'Thing']	7	['appearance', 'box', 'cabin', 'clothing', 'photo', 'planter', 'ship']	18
hasStyle	5	['Art', 'Chair', 'Couch', 'Loveseat', 'Sofa']	4	['art', 'painter', 'style', 'suit']	9
hasType	11	['Area', 'Couch', 'Home', 'Information', 'Kind', 'Place', 'Question', 'Room', 'Service', 'Water', 'Way']	10	['ability', 'building', 'contract', 'damage', 'emancipation', 'home', 'material', 'memory', 'resource', 'thought']	21
height	3	['Couch', 'Loveseat', 'Man']	3	['area', 'monument', 'volume']	6
length	5	['Area', 'Couch', 'Line', 'Way', 'Word']	5	['foot', 'line', 'river', 'song', 'volume']	10
material	6	['Chair', 'Couch', 'Door', 'Loveseat', 'Money', 'Sofa']	2	['dress', 'thing']	8
size	9	['Couch', 'Eye', 'Group', 'Lot', 'Loveseat', 'Number', 'Room', 'Sofa', 'World']	7	['audience', 'clothe', 'crowd', 'dress', 'introduction', 'land', 'vessel']	16
width	3	['Area', 'Couch', 'Loveseat']	3	['area', 'foot', 'volume']	6
area	6	['City', 'Country', 'House', 'Lot', 'Room', 'World']	3	['island', 'nation', 'settlement']	9
capacity	2	['Power', 'Room']	1	['vessel']	3
hasArea	10	['Area', 'City', 'Country', 'Home', 'House', 'Lot', 'Place', 'Room', 'State', 'World']	8	['country', 'island', 'nation', 'region', 'sea', 'state', 'town', 'village']	18
hasCapacity	2	['Lot', 'Room']	2	['tavern', 'transportation']	4
hasFunction	4	['Eye', 'Hand', 'Room', 'System']	1	['institution']	5
hasFurniture	3	['Home', 'Office', 'Room']	3	['household', 'office', 'room']	6
hasRoom	4	['Home', 'House', 'Office', 'Room']	2	['home', 'household']	6
isLocatedIn	9	['City', 'Community', 'Company', 'Country', 'House', 'Place', 'Room', 'State', 'World']	2	['activism', 'village']	11
isOfType	1	['Room']	1	['collection']	2
locatedIn	13	['Art', 'City', 'Community', 'Company', 'Door', 'Government', 'Home', 'Office', 'Place', 'Room', 'State', 'Team', 'World']	3	['officer', 'researcher', 'state']	16
type	5	['Change', 'Force', 'Question', 'Room', 'Service']	5	['audience', 'dress', 'effect', 'manuscript', 'treatment']	10
endsAt	4	['Day', 'Morning', 'Night', 'War']	1	['process']	5
hasActivity	4	['Community', 'Day', 'Morning', 'Night']	1	['activist']	5
hasEndTime	11	['Business', 'Change', 'Day', 'End', 'Moment', 'Morning', 'Night', 'Result', 'Time', 'War', 'Work']	6	['church', 'end', 'exchange', 'period', 'service', 'time']	17
hasStartTime	10	['Business', 'Change', 'Day', 'Moment', 'Morning', 'Night', 'Result', 'Time', 'War', 'Work']	5	['church', 'exchange', 'period', 'service', 'time']	15
startsAt	3	['Day', 'Morning', 'Night']	1	['process']	4
time	2	['Moment', 'Morning']	1	['escape']	3
address	9	['Company', 'Home', 'House', 'Information', 'Lot', 'Office', 'Party', 'People', 'Person']	4	['gift', 'home', 'property', 'store']	13
city	5	['Company', 'Home', 'Party', 'Person', 'Place']	1	['person']	6
date	5	['Community', 'End', 'History', 'Moment', 'Party']	17	['arrest', 'battle', 'ceremony', 'contribution', 'convention', 'diary', 'example', 'funeral', 'gospel', 'loss', 'manuscript', 'occasion', 'publisher', 'raid', 'release', 'speech', 'wedding']	22
hasAttendee	1	['Party']	2	['event', 'party']	3
hasBirthDate	4	['Art', 'Family', 'Party', 'Woman']	4	['birth', 'life', 'painter', 'politician']	8
hasDate	10	['Day', 'End', 'Fact', 'History', 'Idea', 'Information', 'Moment', 'Party', 'Result', 'War']	20	['anniversary', 'arrest', 'battle', 'comment', 'diary', 'emancipation', 'event', 'information', 'manuscript', 'meeting', 'newspaper', 'obituary', 'page', 'party', 'petition', 'photo', 'plaque', 'preface', 'purchase', 'report']	30
hasDateTime	3	['Moment', 'Party', 'Time']	2	['kidnapping', 'violence']	5
hasGuest	1	['Party']	2	['party', 'wedding']	3
hasHost	1	['Party']	1	['party']	2
hasLeader	6	['Community', 'Government', 'Group', 'Party', 'Team', 'War']	1	['expedition']	7
hasMember	7	['Community', 'Family', 'Government', 'Group', 'Member', 'Party', 'Team']	12	['association', 'community', 'congregation', 'crew', 'group', 'household', 'legislature', 'militia', 'organization', 'politic', 'project', 'society']	19
hasOrganizer	1	['Party']	2	['event', 'party']	3
hasTheme	2	['Party', 'Story']	1	['party']	3
hasTime	8	['Change', 'Day', 'End', 'Moment', 'Party', 'Result', 'Time', 'Work']	3	['end', 'situation', 'view']	11
member	5	['Community', 'Family', 'Group', 'Party', 'Team']	2	['member', 'project']	7
participatesIn	5	['Community', 'Kid', 'Party', 'Team', 'War']	4	['activism', 'activist', 'controversy', 'missionary']	9
birthdate	4	['Child', 'Family', 'People', 'Person']	1	['activist']	5
dateOfBirth	2	['Family', 'People']	1	['physician']	3
firstName	8	['Company', 'Family', 'Guy', 'Name', 'Parent', 'People', 'Student', 'Team']	3	['governor', 'physician', 'servant']	11
hasDateOfBirth	2	['Family', 'Member']	3	['ancestry', 'baby', 'individual']	5
hasFather	4	['Family', 'Father', 'Man', 'Parent']	4	['ancestry', 'birth', 'grandfather', 'infant']	8
hasFirstName	8	['Child', 'Company', 'Family', 'Guy', 'Name', 'People', 'Person', 'President']	6	['individual', 'name', 'passenger', 'people', 'professor', 'worker']	14
hasGender	12	['Community', 'Family', 'Friend', 'Girl', 'Guy', 'Health', 'Kid', 'Man', 'Parent', 'People', 'Person', 'Woman']	6	['actor', 'baby', 'guest', 'individual', 'people', 'worker']	18
hasLastName	8	['Child', 'Company', 'Family', 'Guy', 'Name', 'People', 'Person', 'President']	6	['individual', 'name', 'passenger', 'people', 'professor', 'worker']	14
hasMother	5	['Family', 'Man', 'Mother', 'Parent', 'Woman']	4	['ancestry', 'birth', 'infant', 'mother']	9
hasSpouse	7	['Family', 'Father', 'Guy', 'Man', 'Mother', 'Parent', 'Person']	3	['marriage', 'widow', 'wife']	10
isChildOf	3	['Child', 'Family', 'Parent']	1	['girl']	4
isMale	2	['Child', 'Family']	1	['hero']	3
lastName	8	['Company', 'Family', 'Guy', 'Name', 'Parent', 'People', 'Student', 'Team']	4	['governor', 'physician', 'servant', 'surname']	12
sibling	2	['Family', 'Girl']	2	['brother', 'uncle']	4
endTime	7	['Hour', 'Job', 'Moment', 'Night', 'Service', 'Time', 'War']	4	['attempt', 'class', 'end', 'history']	11
hasMinutes	3	['Day', 'Hour', 'Minute']	1	['hour']	4
hasSecond	2	['Hour', 'Time']	1	['pair']	3
startTime	7	['Hour', 'Job', 'Moment', 'Night', 'Service', 'Time', 'War']	3	['attempt', 'class', 'history']	10
capital	4	['City', 'Country', 'State', 'World']	2	['nation', 'state']	6
country	6	['City', 'Company', 'Government', 'Money', 'Person', 'Place']	3	['freedom', 'island', 'person']	9
hasPopulation	6	['City', 'Country', 'Place', 'President', 'State', 'World']	10	['coast', 'country', 'county', 'homeland', 'island', 'nation', 'region', 'state', 'town', 'village']	16
isInCountry	1	['City']	1	['road']	2
population	7	['City', 'Community', 'Country', 'Government', 'Place', 'State', 'World']	6	['island', 'land', 'nation', 'settlement', 'state', 'world']	13
atLocation	1	['Study']	2	['care', 'party']	3
duration	4	['Moment', 'Night', 'Study', 'Time']	6	['effect', 'movement', 'pension', 'period', 'tour', 'treatment']	10
enrolledIn	5	['Child', 'Education', 'School', 'Student', 'Study']	1	['university']	6
hasDuration	9	['Friend', 'Minute', 'Moment', 'Night', 'Program', 'Service', 'Study', 'Time', 'Work']	8	['activity', 'condition', 'kidnapping', 'practice', 'prayer', 'study', 'suffering', 'travel']	17
hasLevel	2	['Level', 'Study']	3	['ability', 'independence', 'level']	5
hasResult	5	['Change', 'Problem', 'Result', 'Study', 'War']	1	['battle']	6
hasStudent	5	['Education', 'Result', 'School', 'Study', 'Teacher']	3	['class', 'school', 'teacher']	8
isTaughtBy	1	['Study']	1	['course']	2
reads	1	['Study']	1	['reader']	2
teaches	7	['Education', 'Information', 'Kind', 'School', 'Student', 'Study', 'Teacher']	4	['course', 'school', 'teacher', 'university']	11
cost	1	['Service']	1	['tour']	2
hasConsumer	1	['Service']	1	['service']	2
hasCustomer	1	['Service']	2	['purchase', 'sale']	3
hasProvider	1	['Service']	2	['care', 'service']	3
isProvidedBy	1	['Service']	1	['service']	2
offeredBy	2	['Education', 'Service']	1	['university']	3
price	5	['Business', 'Lot', 'Loveseat', 'Service', 'Sofa']	2	['purchase', 'shop']	7
providedBy	1	['Service']	1	['support']	2
providerName	1	['Service']	2	['assistance', 'service']	3
providesService	5	['Business', 'Community', 'Government', 'Service', 'System']	1	['service']	6
rating	2	['Game', 'Service']	2	['review', 'tour']	4
serviceName	2	['Business', 'Service']	1	['service']	3
currency	2	['Country', 'Money']	3	['fund', 'nation', 'wage']	5
hasCapital	3	['Country', 'State', 'World']	3	['country', 'nation', 'region']	6
hasCurrency	2	['Country', 'Money']	2	['earning', 'money']	4
isInContinent	1	['Country']	1	['country']	2
officialLanguage	1	['Country']	1	['homeland']	2
hasTexture	2	['Face', 'Thing']	1	['cotton']	3
involves	4	['Case', 'Law', 'Thing', 'War']	1	['money']	5
isUsedFor	1	['Thing']	1	['protection']	2
hasFact	1	['Fact']	1	['fact']	2
hasObject	1	['Fact']	2	['desire', 'statement']	3
hasPredicate	1	['Fact']	1	['statement']	2
hasSource	7	['Change', 'Fact', 'Information', 'Power', 'Question', 'Water', 'Way']	4	['fire', 'information', 'knowledge', 'testimony']	11
hasValue	7	['Area', 'Fact', 'Information', 'Money', 'Number', 'Power', 'Result']	7	['acre', 'estate', 'half', 'level', 'result', 'reward', 'value']	14
isVerified	2	['Fact', 'Information']	1	['testimony']	3
source	5	['Fact', 'Information', 'Power', 'Water', 'Way']	2	['press', 'water']	7
hasNumericValue	1	['Minute']	1	['value']	2
hasSeconds	2	['Day', 'Minute']	1	['hour']	3
hasUnit	5	['Area', 'Force', 'Minute', 'Power', 'Result']	2	['acre', 'resource']	7
amount	2	['Money', 'Power']	7	['contribution', 'debt', 'donation', 'earning', 'fund', 'price', 'wage']	9
hasMagnitude	2	['Force', 'Power']	1	['force']	3
hasPower	1	['Power']	1	['hero']	2
isMeasuredIn	1	['Power']	1	['loss']	2
isUsedIn	2	['Power', 'Sofa']	3	['carriage', 'cotton', 'symbol']	5
unit	2	['Area', 'Power']	1	['volume']	3
hasWidth	4	['Chair', 'Door', 'Loveseat', 'Sofa']	1	['image']	5
belongs	2	['Community', 'Government']	1	['priesthood']	3
hasComment	2	['Community', 'Result']	1	['reputation']	3
hasInstitution	1	['Community']	1	['society']	2
hasInterest	2	['Community', 'Guy']	1	['interest']	3
hasRole	6	['Business', 'Community', 'Company', 'Group', 'Office', 'Team']	7	['crew', 'militia', 'overseer', 'project', 'role', 'society', 'trading']	13
memberCount	1	['Community']	1	['group']	2
participant	2	['Community', 'War']	2	['battle', 'result']	4
writtenBy	2	['Community', 'Story']	1	['literature']	3
causedBy	3	['Change', 'Reason', 'War']	2	['damage', 'smallpox']	5
causes	4	['Change', 'End', 'Reason', 'Result']	3	['cause', 'change', 'loss']	7
hasCause	3	['Change', 'Problem', 'War']	10	['cause', 'damage', 'death', 'health', 'injury', 'pain', 'rebel', 'rebellion', 'struggle', 'suffering']	13
hasChangeType	1	['Change']	1	['change']	2
hasImpact	3	['Change', 'Idea', 'Problem']	3	['circumstance', 'risk', 'struggle']	6
hasTarget	1	['Change']	1	['attack']	2
occursAt	1	['Change']	2	['change', 'circumstance']	3
author	4	['Book', 'Information', 'Story', 'Word']	12	['article', 'book', 'diary', 'example', 'gospel', 'manuscript', 'memoir', 'novel', 'press', 'publication', 'publisher', 'writing']	16
contains	6	['Air', 'Home', 'Information', 'Reason', 'Week', 'World']	2	['cave', 'water']	8
content	2	['History', 'Information']	7	['article', 'diary', 'issue', 'manuscript', 'review', 'song', 'speech']	9
creationDate	4	['Art', 'Case', 'Group', 'Information']	1	['website']	5
hasContent	3	['Information', 'Question', 'Word']	8	['belief', 'comment', 'diary', 'newspaper', 'page', 'preface', 'record', 'report']	11
hasDataType	1	['Information']	1	['information']	2
hasFormat	1	['Information']	1	['image']	2
hasTimestamp	2	['Information', 'Result']	1	['request']	3
isDerivedFrom	1	['Information']	1	['information']	2
hasAddress	9	['Book', 'Company', 'Friend', 'Home', 'House', 'Kid', 'Lot', 'Place', 'School']	6	['building', 'guest', 'home', 'neighbor', 'petition', 'residence']	15
hasBathrooms	1	['House']	2	['cabin', 'home']	3
hasBedrooms	1	['House']	2	['cabin', 'home']	3
hasLivingRoom	1	['House']	1	['home']	2
hasOwner	4	['Business', 'Home', 'House', 'Lot']	7	['account', 'building', 'domain', 'estate', 'home', 'residence', 'tavern']	11
hasRooms	2	['Home', 'House']	1	['home']	3
ownedBy	1	['House']	2	['bond', 'transportation']	3
owner	3	['Home', 'House', 'Lot']	2	['cabin', 'property']	5
owns	3	['Business', 'Home', 'House']	2	['home', 'owner']	5
associatedWith	4	['Case', 'End', 'Level', 'Result']	4	['reputation', 'result', 'spring', 'theme']	8
cause	1	['End']	3	['damage', 'disease', 'effect']	4
hasActor	1	['End']	3	['controversy', 'film', 'play']	4
isEndOf	1	['End']	1	['end']	2
isResultOf	2	['End', 'Result']	1	['result']	3
hasApplication	1	['System']	1	['principle']	2
hasComponent	3	['Air', 'Face', 'System']	2	['meal', 'system']	5
hasHardware	1	['System']	1	['system']	2
hasInput	2	['Program', 'System']	2	['conversion', 'process']	4
hasObjective	1	['System']	1	['attempt']	2
hasOutput	2	['Program', 'System']	2	['conversion', 'process']	4
hasSoftware	1	['System']	1	['system']	2
hasVersion	2	['Program', 'System']	1	['version']	3
isComponentOf	1	['System']	1	['system']	2
partOf	7	['Hand', 'Office', 'Part', 'School', 'State', 'System', 'World']	3	['abolition', 'foot', 'vessel']	10
friend	1	['Friend']	1	['friendship']	2
hasFriend	1	['Friend']	1	['friendship']	2
hasPosition	5	['Face', 'Hand', 'Job', 'Team', 'Work']	2	['official', 'organization']	7
x	2	['Line', 'Point']	1	['line']	3
xCoordinate	2	['Line', 'Point']	2	['point', 'position']	4
y	2	['Line', 'Point']	1	['line']	3
yCoordinate	2	['Line', 'Point']	2	['point', 'position']	4
zCoordinate	1	['Point']	2	['point', 'position']	3
hasGrade	5	['Child', 'Education', 'Result', 'School', 'Student']	2	['institution', 'school']	7
hasOutcome	2	['Result', 'War']	2	['decision', 'rebellion']	4
outcome	1	['Result']	1	['circumstance']	2
score	1	['Result']	1	['result']	2
timestamp	1	['Result']	1	['conversation']	2
belongsGroup	1	['Member']	1	['rebel']	2
email	3	['Member', 'Office', 'Person']	5	['account', 'course', 'gift', 'physician', 'teacher']	8
hasEmail	1	['Member']	2	['mail', 'website']	3
hasCity	4	['Government', 'Home', 'Lot', 'World']	5	['address', 'homeland', 'land', 'location', 'passenger']	9
residesIn	2	['Home', 'Person']	2	['neighbor', 'resident']	4
bornIn	3	['Art', 'People', 'Person']	1	['native']	4
isMarried	5	['Man', 'Mother', 'People', 'Person', 'Woman']	2	['man', 'person']	7
jobTitle	3	['Job', 'Person', 'Work']	1	['servant']	4
nationality	3	['Art', 'Man', 'Person']	1	['activist']	4
phone	1	['Person']	1	['physician']	2
playsSport	3	['Guy', 'Kid', 'Team']	1	['boy']	4
worksAt	6	['Education', 'Guy', 'Health', 'Office', 'School', 'Teacher']	8	['chef', 'doctor', 'lawyer', 'officer', 'preacher', 'scholar', 'seamstress', 'teacher']	14
worksIn	5	['Guy', 'Office', 'Teacher', 'Woman', 'Work']	7	['agent', 'chef', 'lawyer', 'physician', 'professor', 'seamstress', 'teacher']	12
hasEye	3	['Eye', 'Face', 'Head']	1	['face']	4
hasFeature	1	['Face']	1	['face']	2
hasMouth	2	['Face', 'Head']	1	['face']	3
hasNose	2	['Face', 'Head']	1	['face']	3
shape	2	['Eye', 'Face']	1	['thing']	3
hasRelationship	1	['Mother']	1	['relationship']	2
isMotherOf	3	['Mother', 'Parent', 'Woman']	1	['woman']	4
motherOf	1	['Mother']	1	['relative']	2
belongsIn	1	['Week']	1	['community']	2
consistsOf	4	['Air', 'Education', 'Government', 'Week']	1	['society']	5
hasDegree	2	['Education', 'Teacher']	1	['teacher']	3
hasExperience	3	['Program', 'Teacher', 'Team']	6	['carpenter', 'laborer', 'lawyer', 'overseer', 'seamstress', 'teacher']	9
school	3	['Child', 'Kid', 'Teacher']	1	['teacher']	4
teachesSubject	3	['Education', 'School', 'Teacher']	2	['professor', 'teacher']	5
yearsOfExperience	1	['Teacher']	1	['chef']	2
hasCategory	2	['Kind', 'Question']	2	['merchant', 'shop']	4
hasConclusion	1	['Reason']	2	['argument', 'end']	3
hasEvidence	1	['Reason']	1	['belief']	2
hasPremise	1	['Reason']	1	['argument']	2
hasPurpose	1	['Reason']	3	['mission', 'prayer', 'punishment']	4
hasReason	2	['Reason', 'War']	1	['arrest']	3
reason	1	['Reason']	1	['escape']	2
placeName	1	['Place']	1	['history']	2
genre	4	['Art', 'Book', 'Game', 'Story']	4	['book', 'novel', 'song', 'writing']	8
hasGenre	3	['Book', 'Game', 'Story']	6	['artist', 'film', 'song', 'story', 'tale', 'text']	9
hasISBN	1	['Book']	1	['isbn']	2
hasPageCount	1	['Book']	1	['paper']	2
hasPublisher	1	['Book']	1	['newspaper']	2
isbn	1	['Book']	2	['book', 'publication']	3
numberOfPages	1	['Book']	1	['novel']	2
pages	1	['Book']	1	['book']	2
publicationDate	2	['Book', 'Story']	1	['article']	3
publicationYear	2	['Book', 'Story']	2	['bibliography', 'novel']	4
publishedDate	1	['Book']	1	['writing']	2
publishedYear	1	['Book']	2	['book', 'memoir']	3
publisher	2	['Book', 'Game']	2	['press', 'publication']	4
hasOrder	1	['Month']	1	['list']	2
hasTemperature	4	['Air', 'Day', 'Night', 'Water']	3	['spring', 'star', 'water']	7
hasWeather	2	['Day', 'Night']	1	['spring']	3
hasContinent	2	['President', 'World']	1	['nation']	3
hasCountry	4	['Company', 'Lot', 'President', 'World']	5	['address', 'homeland', 'land', 'location', 'passenger']	9
hasLanguage	3	['Program', 'Word', 'World']	1	['literacy']	4
hosts	1	['World']	1	['occasion']	2
casualties	1	['War']	1	['battle']	2
endYear	1	['War']	1	['rebellion']	2
endsOn	1	['War']	1	['spring']	2
hasParticipant	1	['War']	4	['conversation', 'exchange', 'meeting', 'situation']	5
hasParticipatingCountry	1	['War']	1	['battle']	2
hasTimeframe	1	['War']	1	['success']	2
startYear	1	['War']	1	['rebellion']	2
usesWeapon	1	['War']	1	['rebel']	2
value	3	['Area', 'Money', 'Number']	1	['mean']	4
hasCaptain	1	['Team']	1	['ship']	2
role	2	['Story', 'Team']	1	['duty']	3
companyName	1	['Work']	1	['work']	2
employedBy	1	['Work']	1	['worker']	2
employeeName	3	['Company', 'Office', 'Work']	1	['work']	4
employer	2	['Job', 'Work']	1	['servant']	3
hasEmployee	4	['Business', 'Company', 'Office', 'Work']	1	['office']	5
hasFullName	3	['Company', 'Name', 'Work']	1	['individual']	4
hasJobTitle	3	['Company', 'Job', 'Work']	2	['adulthood', 'worker']	5
receives	3	['Education', 'Health', 'Work']	1	['favor']	4
worksFor	2	['Job', 'Work']	2	['editor', 'servant']	4
caseStatus	1	['Case']	1	['case']	2
hasDefendant	1	['Case']	1	['trial']	2
hasIdentifier	2	['Case', 'Law']	1	['record']	3
hasJudge	1	['Case']	3	['courthouse', 'justice', 'trial']	4
hasLawyer	1	['Case']	2	['courthouse', 'justice']	3
hasParty	1	['Case']	1	['politic']	2
judge	1	['Case']	2	['court', 'trial']	3
applies	1	['Law']	1	['drag']	2
hasArticle	1	['Law']	1	['newspaper']	2
hasCase	1	['Law']	2	['courthouse', 'trial']	3
hasCourt	1	['Law']	1	['justice']	2
hasJurisdiction	1	['Law']	1	['court']	2
hasText	2	['Law', 'Question']	1	['petition']	3
judges	1	['Law']	1	['judge']	2
represents	1	['Law']	3	['behalf', 'court', 'law']	4
diagnosedWith	1	['Health']	1	['condition']	2
hasCondition	2	['Back', 'Health']	1	['condition']	3
hasDisease	2	['Eye', 'Health']	1	['health']	3
hasHeight	4	['Chair', 'Door', 'Health', 'Sofa']	3	['baby', 'image', 'man']	7
hasPatient	1	['Health']	1	['physician']	2
hasSymptom	2	['Back', 'Health']	2	['condition', 'health']	4
hasTreatment	2	['Eye', 'Health']	2	['condition', 'health']	4
hasWeight	2	['Health', 'Part']	2	['baby', 'capacity']	4
manages	2	['Health', 'Office']	1	['construction']	3
operatesIn	2	['Business', 'Health']	1	['merchant']	3
treats	1	['Health']	1	['treatment']	2
hasBody	1	['Question']	1	['mail']	2
hasResponse	1	['Question']	2	['response', 'suffering']	3
direction	1	['Force']	1	['movement']	2
hasDirection	3	['Force', 'Line', 'Way']	1	['force']	4
hasStrength	1	['Force']	1	['belief']	2
containsOxygen	1	['Air']	1	['water']	2
hasVolume	1	['Air']	2	['capacity', 'trading']	3
temperature	2	['Air', 'Water']	1	['sea']	3
hasRating	1	['Game']	1	['reputation']	2
hasSkillLevel	1	['Game']	2	['practice', 'skill']	3
releaseDate	2	['Game', 'Program']	1	['film']	3
reviewOf	1	['Game']	1	['review']	2
courseName	2	['School', 'Student']	1	['course']	3
hasClass	1	['School']	1	['school']	2
hasTeacher	2	['Education', 'School']	2	['class', 'school']	4
teachesCourse	2	['Education', 'School']	1	['university']	3
createdOn	1	['Group']	1	['account']	2
artist	1	['Art']	1	['song']	2
createdBy	1	['Art']	2	['art', 'website']	3
hasArtist	1	['Art']	1	['painting']	2
hasCreator	2	['Art', 'Idea']	2	['image', 'statue']	4
hasMedium	2	['Art', 'Way']	3	['information', 'medium', 'painting']	5
madeOf	3	['Art', 'Door', 'Part']	2	['clothe', 'vessel']	5
endPoint	2	['Line', 'Way']	1	['line']	3
hasStart	3	['Line', 'Night', 'Way']	1	['spring']	4
startPoint	2	['Line', 'Way']	1	['line']	3
distance	1	['Way']	1	['movement']	2
from	1	['Way']	1	['escape']	2
hasDestination	1	['Way']	3	['expedition', 'passenger', 'travel']	4
takenBy	1	['Way']	1	['photo']	2
to	1	['Way']	1	['escape']	2
hasCreationDate	1	['Idea']	4	['collection', 'document', 'image', 'record']	5
hasIdea	1	['Idea']	1	['idea']	2
hasOrigin	2	['Idea', 'Word']	3	['artist', 'character', 'origin']	5
hasOriginator	1	['Idea']	2	['abolitionism', 'idea']	3
hasBirthdate	1	['Woman']	1	['autobiography']	2
hasChildren	2	['Man', 'Woman']	1	['man']	3
isWifeOf	1	['Woman']	1	['wife']	2
hasCode	1	['Program']	1	['nation']	2
hasLicense	1	['Program']	1	['lawyer']	2
isCreatedBy	1	['Program']	1	['information']	2
runsOn	1	['Program']	1	['railroad']	2
version	1	['Program']	1	['release']	2
writtenIn	1	['Program']	1	['text']	2
hasEducation	1	['Education']	1	['lawyer']	2
belongsToDomain	1	['Problem']	1	['idea']	2
hasEffect	1	['Problem']	1	['circumstance']	2
isTypeOf	1	['Problem']	2	['force', 'relationship']	3
severity	1	['Problem']	2	['damage', 'punishment']	3
established	1	['Government']	2	['cemetery', 'memorial']	3
hasBranch	1	['Government']	1	['branch']	2
hasDepartment	4	['Business', 'Company', 'Government', 'Office']	3	['fire', 'institution', 'university']	7
hasState	3	['Government', 'State', 'Water']	2	['address', 'land']	5
holdsPosition	1	['Government']	2	['authority', 'politician']	3
grantedBy	1	['Right']	2	['authority', 'manumission']	3
hasRight	1	['Right']	1	['right']	2
isProtectedBy	1	['Right']	1	['right']	2
fatherOf	2	['Father', 'Man']	1	['relative']	3
parent	1	['Child']	1	['uncle']	2
hasPet	1	['Kid']	1	['boy']	2
hasZipCode	1	['Lot']	1	['address']	2
usedIn	3	['Part', 'Water', 'Word']	1	['medium']	4
hasDefinition	1	['Word']	1	['principle']	2
hasSpelling	1	['Word']	1	['word']	2
isSynonymOf	1	['Word']	1	['word']	2
hasCharacter	2	['History', 'Story']	2	['scene', 'tale']	4
hasCharacterName	1	['Story']	1	['story']	2
hasCharacters	1	['Story']	2	['story', 'tale']	3
hasPlot	1	['Story']	2	['story', 'tale']	3
hasSetting	1	['Story']	1	['tale']	2
affects	1	['Back']	2	['damage', 'fate']	3
isLocationOf	1	['Back']	1	['coast']	2
belongsCountry	2	['President', 'State']	1	['president']	3
hasTerm	1	['President']	2	['politician', 'president']	3
servesIn	1	['President']	1	['soldier']	2
termEnd	1	['President']	1	['governor']	2
termStart	1	['President']	1	['governor']	2
hasCEO	2	['Business', 'Company']	1	['company']	3
hasDirector	1	['Company']	2	['film', 'play']	3
hasEmployeeCount	1	['Company']	1	['company']	2
hasIndustry	1	['Company']	1	['company']	2
yearEstablished	1	['Company']	1	['monument']	2
hasSkill	1	['Level']	4	['laborer', 'practice', 'seamstress', 'website']	5
hasDepth	1	['Chair']	1	['sea']	2
hasMajor	1	['Student']	1	['student']	2
hasMinor	1	['Student']	1	['student']	2
occurredAt	1	['History']	1	['assault']	2
occursIn	1	['History']	1	['circumstance']	2
participatedIn	1	['History']	1	['abolitionist']	2
hasMake	1	['Car']	1	['transportation']	2
hasModel	1	['Car']	2	['carriage', 'transportation']	3
hasEar	1	['Head']	1	['face']	2
hasPH	1	['Water']	1	['water']	2
salinity	1	['Water']	1	['sea']	2
hasSecurityLevel	1	['Door']	1	['prison']	2
hasAmount	1	['Money']	1	['aid']	2
hasDenomination	1	['Money']	2	['church', 'prayer']	3
transfers	1	['Money']	1	['power']	2
generates	1	['Business']	1	['power']	2
hasProduct	1	['Business']	3	['purchase', 'shop', 'trade']	4
hires	1	['Business']	1	['servant']	2
sells	1	['Business']	2	['merchant', 'shop']	3
serves	1	['Business']	1	['priesthood']	2
supplies	1	['Business']	1	['supply']	2
